111W111W1111W11
1FL0M00T00M0LF1
1000K0000000001
1000000P0000001
1F00C00000000F1
111111011111111
100000000000001
1Z0000E00000001
111111111111111