1111W1111W11111W11111W1111W1W11111
1L00MTM00000000C001FEL1LMMMMMMMML1
1000000000100000001000100000000001
W00000001110000000110110000K00000W
1FP000001C00C0000000000000000000C1
1111111111111110011111111111111111
1F000Z000F100000000001L00M0T0M00L1
100000000000000010100100000000000W
W000000000101010001000000000000001
1L0000C00L10C000000001F00000000CF1
11111W1111111111111111111111W11111